1637,1638,1637,1638,1637,1638,1637,1638,1637,1638,1637,1638,1637,1638,1637,1638,1637,1638,1637,1638,1637,1638,1637,1638,1637,1638,1637,1638,1637,1638,1,1,1,1,1,1,1,1489,1490,1491,
1645,1646,1645,1646,1645,1646,1645,1646,1645,1646,1645,1646,1645,1646,1645,1646,1645,1646,1645,1646,1645,1646,1645,1646,1645,1646,1645,1646,1645,1646,1,1,1,1,1,1,1,1497,1497,1497,
1637,1638,826,826,826,1,1,1,1,1,1,1,1,1,1,1,1,1,1,1,1,1,1,1,1,1,1,1,1,1,1,1,1,1,1,1,1,1505,1506,1507,
1645,1646,826,826,826,826,1,1878,1,1,1,1,1,1,1,1,1,1,1,1,1,1,1,1,1,1,1,1,1,1,1,1,1,1,1398,1399,1400,1513,1514,1515,
1637,1638,826,826,826,826,826,1886,1,1,1,1,1,1,1,1,1,1,1,2406,1,1,1,1,1,1,1,1,1,1,1,1,1,1,1406,1407,1408,1,1,1,
1645,1646,1,826,826,826,826,826,1,1,1,1,1,1,1,1,1,1,1,2414,1,1,1,1,1,1,1,1,1,1,1,1,1,1,1414,1415,1416,1,1,1,
1637,1638,1,1878,826,826,826,826,826,1,1,1,1,1,1,1,1,1,1,1,1,1,1,1,1,1,1,1,1,1,1,1,1,1,1422,1423,1424,1,1,1,
1645,1646,1,1886,1,826,826,826,826,826,1,1636,1,1636,1636,1636,1636,1,1,1636,1636,1636,1636,1636,1636,1636,1636,1,1,1,1,1,1,1,1,1,1,1,1,1,
1637,1638,1,1,1,1,826,826,826,826,826,1644,1636,1644,1644,1644,1644,1,1,1644,1644,1644,1644,1644,1644,1644,1644,1636,1,1,1,1,1,1,1,1,1,1,1,1,
1645,1646,1,1,1,1,1,826,826,826,826,826,1644,1636,1,1,1,1,1,1,1,1,1,1,1,1,1636,1644,1,1,1,1,1,1,1,1,1,1,1,1,
1637,1638,1,1,1,1,1,1636,826,826,826,826,826,1644,1,1,1,1,1,1,1,1,1,1,1,1636,1644,826,826,826,1,1,1,1,1,1,1,1,1637,1638,
1645,1646,1,1,1,1,1,1644,1636,826,826,826,826,826,1,1,1,1,1,1,1,1,1,1,1,1644,826,826,826,826,1,1,1,1,1,1,1,1,1645,1646,
1637,1638,1,1,1,1,1,1636,1644,1636,826,826,826,826,826,1,1636,1,1,1,1,1,1,1,1,826,826,826,826,826,1636,1636,1,1,1,1,1,1,1637,1638,
1645,1646,1,1,1,1,1,1644,1,1644,1,826,826,826,826,826,1644,1636,1,1,1,1,1636,1,826,826,826,2406,826,1636,1644,1644,1636,1,1,1,1,1,1645,1646,
1637,1638,1,1,1,1,1,1636,1,1,1,1,826,826,826,826,826,1644,1636,1,1,1636,1644,826,826,826,826,2414,1636,1644,1,1,1644,1,1,1,1,1,1637,1638,
1645,1646,1,1,1,1,1,1644,1,1,1,1,1636,826,826,826,826,826,1644,1636,1636,1644,826,826,826,826,826,1,1644,1,1,1,1636,1,1,1,1,1,1645,1646,
1637,1638,1,1,1,1,1,1636,1,1,1,1,1644,1636,826,826,826,826,826,1644,1644,826,826,826,826,826,1,1,1,1,1,1,1644,1,1,1,1,1,1637,1638,
1645,1646,1,1,1,1,1,1644,1,1,1,1,1,1644,1636,826,826,826,826,826,826,826,826,826,826,1636,1,1,1,1,1,1,1636,1,1,1,1,1,1645,1646,
1637,1638,1,1,1,1,1,1,1,1,1,1,1,1,1644,1636,826,826,826,826,826,826,1878,826,1636,1644,1,1,1,1,1,1,1644,1,1,1,1,1,1637,1638,
1645,1646,1,1,1,1,1,1,1,1,1,1,1,1,1,1644,1636,826,826,826,826,826,1886,1636,1644,1,1,1,1,1,1,1,1636,1,2406,1,1,1,1645,1646,
1637,1638,1,1,1,2406,1,1636,1,1,1,1,1,1,1,1636,1644,1878,826,826,826,826,826,1644,1636,1,1,1,1,1,1,1,1644,1,2414,1,1,1,1637,1638,
1645,1646,1,1,1,2414,1,1644,1,1,1,1,1,1,1636,1644,826,1886,826,826,826,826,826,826,1644,1636,1,1,1,1,1,1,1,1,1,1,1,1,1645,1646,
1637,1638,1,1,1,1,1,1636,1,1,1,1,1,1636,1644,826,826,826,826,826,826,826,826,826,826,1644,1636,1,1,1,1,1,1,1,1,1,1,1,1637,1638,
1645,1646,1,1,1,1,1,1644,1,1,1,1,1,1644,826,826,826,826,826,1636,1636,826,826,826,826,826,1644,1,1,1,1,1,1636,1,1,1,1,1,1645,1646,
1637,1638,1,1,1,1,1,1636,1,1,1,1,1,826,826,826,826,826,1636,1644,1644,1636,826,826,826,826,826,1,1,1,1,1,1644,1,1,1,1,1,1637,1638,
1645,1646,1,1,1,1,1,1644,1,1,1636,1,826,826,826,826,826,1636,1644,1,1,1644,1636,826,826,826,826,826,1,1636,1,1,1636,1,1,1,1,1,1645,1646,
1637,1638,1,1,1,1,1,1636,1,1636,1644,2406,826,826,826,826,1636,1644,1,1,1,1,1644,1636,826,826,826,826,826,1644,1636,1,1644,1,1,1,1,1,1637,1638,
1645,1646,1,1,1,1,1,1644,1636,1644,826,2414,826,826,826,1,1644,1,1,1,1,1,1,1644,1,826,826,826,826,826,1644,1636,1636,1,1,1,1,1,1645,1646,
1637,1638,1,1,1,1,1,1,1644,826,826,826,826,826,1,1,1,1,1,1,1,1,1,1,1,1,826,826,826,826,826,1644,1636,1,1,1,1,1,1637,1638,
1645,1646,1,1,1,1,1,1,1,826,826,826,826,1636,1,1,1,1,1,1,1,1,1,1,1,1,1636,826,826,826,826,826,1644,1,1,1,1,1,1645,1646,
1,1,1,1,1,1,1,1,1,1,1,1,1636,1644,1,1,1,1,1,1,1,1,1,1,1,1,1644,1636,826,826,826,826,826,1,1,1,1,1,1637,1638,
1,1,1,1,1,1,1,1,1,1,1,1,1644,1636,1636,1636,1636,1636,1636,1,1,1636,1636,1636,1636,1636,1636,1644,1636,826,826,826,826,826,1,1,1,1,1645,1646,
1,1,1,1,1,1,1,1,1,1,1,1,1,1644,1644,1644,1644,1644,1644,1,1,1644,1644,1644,1644,1644,1644,1,1644,1,826,826,826,826,826,1,1878,1,1637,1638,
1,1,1,1398,1399,1400,1,1,1,1,1,1,1,1,1,1,1,1,1,1,1,1,1,1,1,1,1,1,1,1,1,826,826,826,826,826,1886,1,1645,1646,
1,1,1,1406,1407,1408,1,1,1,1,1,1,1,1,1,1,1,1,2406,1,1,1,1,1,1,1,1,1,1,1,1,1,826,826,826,826,826,1,1637,1638,
1,1,1,1414,1415,1416,1,1,1,1,1,1,1,1,1,1,1,1,2414,1,1,1,1,1,1,1,1,1,1,1,1,1,1878,826,826,826,826,826,1645,1646,
1,1,1,1422,1423,1424,1,1,1,1,1,1,1,1,1,1,1,1,1,1,1,1,1,1,1,1,1,1,1,1,1,1,1886,1,826,826,826,826,1637,1638,
1489,1490,1491,1,1,1,1,1,1,1,1,1,1,1,1,1,1,1,1,1,1,1,1,1,1,1,1,1,1,1,1,1,1,1,1,826,826,826,1645,1646,
1497,1497,1497,1,1,1,1,1,1,1,1637,1638,1637,1638,1637,1638,1637,1638,1637,1638,1637,1638,1637,1638,1637,1638,1637,1638,1637,1638,1637,1638,1637,1638,1637,1638,1637,1638,1637,1638,
1505,1506,1507,1,1,1,1,1,1,1,1645,1646,1645,1646,1645,1646,1645,1646,1645,1646,1645,1646,1645,1646,1645,1646,1645,1646,1645,1646,1645,1646,1645,1646,1645,1646,1645,1646,1645,1646,
